#########S##########
#__________________#
#__________________#
#________L____%____#
#_____________%C___#
#_____________%T___#
#%%%%%%%%o%%%%%%%%%#
#_______%^%________#
#_______%^%________#
#_______%^%________#
#_______%^%________#
#_______%P%________#
#__________________#
#________R_________#
#__________________#
#__________________#
#########F##########
