###S################
#____R%____________#
#____L%____________#
#_____%____________#
#_____%____________#
#_____%____________#
#_____P_C__________#
#_____%____________#
#%o%__%____________#
#%^%__%____________#
#%^%__%____________#
#%^%__%____________#
#%^%__%____________#
#%^%__%____________#
#%^%__%___L___##o###
#%T%__%_______#____#
################F###
