#########S##########
#__________________#
#__________________#
#__________________#
#________L_________#
#__________________#
#__________________#
#__________________#
#%%%%%%%%o%%%%%%%%%#
#__________________#
#__________________#
#__________________#
#__________________#
#__________________#
#__________________#
#__________________#
#########F##########
