#########S##########
#__________________#
#__________________#
#__________________#
#________T_________#
#__________________#
#__________________#
#__________________#
#%%%%%%%%P%%%%%%%%%#
#__________________#
#__________________#
#__________________#
#__________________#
#__________________#
#__________________#
#__________________#
#########F##########
