#########S##########
#__________________#
#_________________T#
#%%%%%%%%%%%%%P%%%%#
#Ro_______________L#
#%%________________#
#________%%%_______#
#%%%%o%%%%L%%%P%%%%#
#____C__________oTT#
#_______________%%%#
#__________________#
#%%%_%%%%%%%%%P%%%%#
#_______%%%%%%_%___#
#_______%_^^^^_%___#
#_______%_%%%%%%___#
#_______%P%________#
#########F##########
